C 255,20 ,30
R  2147483647 2147483647
NO ./textures/desk.xpm
SO ./textures/wall.xpm
EA ./textures/wallred.xpm
WE ./textures/wallblue.xpm

S ./textures/raquette.xpm
F  000, 000, 00



111111111111111111111111111111
111111111000100000000000011111
100000000000020000111000100001
110000100000000000000000001111
100001111111000000010000111111
1111111000000000W0000000000001
111100000000001100000001000011
100000002000000000000000000001
110000000000011110000200000011
100002000000111000000000000011
110000000000111000000000001111
110000000001111000000000000111
111111111111111111111111111111
